SO ./path_to_the_south_texture
WE ./path_to_the_west_texture
NO       ./path_to_the_north_texture
EA ./path_to_the_east_texture
C 245,93,192
F 111,72,211

11111111111
10000000001
10010000001
10000010001
10000N00001
11111111111
