1111
101111
101111
10000001111
1000000000001111
1000000000001111
10000000001111
10000000000111
10N00000001
1111111111
