SO textures/blackberries.xpm
WE textures/lemon.xpm
NO textures/peach.xpm
EA textures/pear.xpm

C 28,85,66
F 88,96,66

11111111111
10000000001111111
10010000000000001
10000010000000001
10000N00001111111
11111111111
