SO textures/blackberries.xpm
WE textures/lemon.xpm
NO textures/peach.xpm
EA textures/pear.xpm

C 28,85,66
F 88,96,66



     11111
    100S001
     10001
      111
       1
