NO textures/peach.xpm
EA textures/pear.xpm
SO textures/blackberries.xpm
WE textures/lemon.xpm

F 255,81,99
C 100,45,87

         111111111111111111111111    1      111111  111
         1000000000110000000000001  101
         1011000001110000000000001  111
         1001000000000000000000001
111111111011000001110000000000001
100000000011000001110111111111111
11110001111111011100000010001
11110101111111011101010010001
11000000110101011100000010001
10000S00000000001100000010001
10000000000000001101010010001
1100000111010101111101100000111
11110111 1110101 101111010001
11111111 1111111 111111111111
